#######
#     #
#######
#     #
# #####
#     #
##### #
#     #
#######
#     #
#######