#######
#   # #
# #####
#   # #
#######